000005.ldb
000007.ldb
000008.log
000009.ldb
000010.log
000011.ldb
CURRENT
LOCK
LOG
MANIFEST-000002
