000005.ldb
000038.ldb
000067.ldb
000068.ldb
000070.ldb
000071.ldb
000073.ldb
000074.log
000075.ldb
000076.log
000077.ldb
CURRENT
LOCK
LOG
LOG.old
MANIFEST-000025
